11111111111111111
1P1000000000000C1
10100101001000001
101001001010101E1
100000000C00C00C1
11111111111111111