111111
100101
1C0001
1PE0E1
111001
111111