111111
100101
1C0001
1P00E1
111001
111111